0 0 0 0 0 0 0 0 0 0 0 0 0 0 0 0 0 0 0 0 0 0 0 0 0 0 0
0 0 0 0 0 0 0 0 0 0 0 0 0 0 0 0 0 0 0 0 0 0 0 0 0 0 0
0 0 0 0 0 0 0 0 0 0 0 0 0 0 0 0 0 0 0 0 0 0 0 0 0 0 0
0 0 0 0 0 0 0 0 0 0 0 0 0 0 0 0 0 0 0 0 0 0 0 0 0 0 0
0 0 0 0 0 0 0 0 0 0 0 0 0 0 0 0 0 0 0 0 0 0 0 0 0 0 0
0 0 0 0 0 1 1 1 1 1 1 1 1 1 1 1 1 1 1 1 1 1 0 0 0 0 0
0 0 0 0 0 1 2 2 2 2 2 2 2 2 2 2 2 2 2 2 2 1 0 0 0 0 0
0 0 0 0 0 1 2 3 3 3 3 3 3 3 3 3 3 3 3 3 2 1 0 0 0 0 0
0 0 0 0 0 1 2 3 10 10 10 10 10 10 10 10 10 10 10 3 2 1 0 0 0 0 0
0 0 0 0 0 1 2 3 10 10 10 10 10 10 10 10 10 10 10 3 2 1 0 0 0 0 0
0 0 0 0 0 1 2 3 10 10 10 10 10 10 10 10 10 10 10 3 2 1 0 0 0 0 0
0 0 0 0 0 1 2 3 10 10 10 10 10 10 10 10 10 10 10 3 2 1 0 0 0 0 0
0 0 0 0 0 1 2 3 10 10 10 10 10 10 10 10 10 10 10 3 2 1 0 0 0 0 0
0 0 0 0 0 1 2 3 10 5 5 5 5 5 5 5 5 5 10 3 2 1 0 0 0 0 0
0 0 0 0 0 1 2 3 10 5 6 6b 6 6 6 6 6 5 10 3 2 1 0 0 0 0 0
0 0 0 0 0 1 2 3 10 5 6 7 7 7 7 7 6 5 10 3 2 1 0 0 0 0 0
0 0 0 0 0 1 2 3 10 5 6 7 8,0xFFFFFF 8,0xFFFFFF 8,0xFFFFFF 7 6 5 10 3 2 1 0 0 0 0 0
0 0 0 0 0 1 2 3 10 5 6 7 8,0xFFFFFF 8,0xFFFFFF 8,0xFFFFFF 7 6 5 10 3 2 1 0 0 0 0 0
0 0 0 0 0 1 2 3 10 5 6 7 8,0xFFFFFF 8,0xFFFFFF 8,0xFFFFFF 7 6 5 10 3 2 1 0 0 0 0 0
0 0 0 0 0 1 2 3 10 5 6 7 8,0xFFFFFF 8,0xFFFFFF 8,0xFFFFFF 7 6 5 10 3 2 1 0 0 0 0 0
0 0 0 0 0 1 2 3 10 5 6 7 8,0xFFFFFF 9,0xFFFFFF 8,0xFFFFFF 7 6 5 10 3 2 1 0 0 0 0 0
0 0 0 0 0 1 2 3 10 5 6 7 8,0xFFFFFF 8,0xFFFFFF 8,0xFFFFFF 7 6 5 10 3 2 1 0 0 0 0 0
0 0 0 0 0 1 2 3 10 5 6 7 7 7 7 7 6 5 10 3 2 1 0 0 0 0 0
0 0 0 0 0 1 2 3 10 5 6 6 6 6 6 6 6 5 10 3 2 1 0 0 0 0 0
0 0 0 0 0 1 2 3 10 5 5 5 5 5 5 5 5 5 10 3 2 1 0 0 0 0 0
0 0 0 0 0 1 2 3 10 10 10 10 10 10 10 10 10 10 10 3 2 1 0 0 0 0 0
0 0 0 0 0 1 2 3 3 3 3 3 3 3 3 3 3 3 3 3 2 1 0 0 0 0 0
0 0 0 0 0 1 2 2 2 2 2 2 2 2 2 2 2 2 2 2 2 1 0 0 0 0 0
0 0 0 0 0 1 1 1 1 1 1 1 1 1 1 1 1 1 1 1 1 1 0 0 0 0 0
0 0 0 0 0 0 0 0 0 0 0 0 0 0 0 0 0 0 0 0 0 0 0 0 0 0 0
0 0 0 0 0 0 0 0 0 0 0 0 0 0 0 0 0 0 0 0 0 0 0 0 0 0 0
0 0 0 0 0 0 0 0 0 0 0 0 0 0 0 0 0 0 0 0 0 0 0 0 0 0 0
0 0 0 0 0 0 0 0 0 0 0 0 0 0 0 0 0 0 0 0 0 0 0 0 0 0 0
0 0 0 0 0 0 0 0 0 0 0 0 0 0 0 0 0 0 0 0 0 0 0 0 0 0 0