0 0  0  0  0  0  0 0 0  0  0  0  0  0 0 0  0  0  0  0  0 0
0 22 0  0  0  22 0 0 22 0  0  0  22 0 0 22 0  0  0  22 22 0
0 0  22 0  22 0  0 0 0  22 0  22 0  0 0 22 0  0  22 0  22 0
0 0  0  22 0  0  0 0 0  0  22 0  0  0 0 22 0  22 0  0  22 0
0 0  22 0  22 0  0 0 0  22 0  0  0  0 0 22 22 0  0  0  22 0
0 22 0  0  0  22 0 0 22 0  0  0  0  0 0 22 0  0  0  0  22 0
0 0  0  0  0  0  0 0 0  0  0  0  0  0 0 0  0  0  0  0  0 0
